#########################
|                       |
|                       |
|                       |              
|              !%%%%%%%!|
|                       |
|                       |
|                       |
|                       |
|                       |
|                       |
|                       |
#########################