#########################
|                       |
|!%%%%%%%%%%!           |
|                 !%%%%!|
|                       |
|                       |
|                       |
|                       |
|                       |
|                       |
|                       |
|                       |
#########################